0000000000000000000100000000000000000000
0000000000000000000111111111111111100000
0000000000000000000000000000000000100000
0000000000000000000000000000000000100000
0111111111111111111111111111111100100000
0100000000000000000000000000000100100000
0100000000000000000000000000000100100000
0100111111111111111100000000000100100000
0100100000000000000100000000000100100000
0100100000000000000100000000000100100000
0100100000000000002220000000000100100000
1100100111111111112221111111111100100111
0000100100000000002220000000000000100100
0000100100000000000100000000000000100100
0000100100000000000100000000000000100100
0000100100000000000111111111111111100100
0000100100000000000000000000000000000100
0000100100000000000000000000000000000100
0000100111111111111111111111111111111100
0000100000000000000000000000000000000000
0000100000000000000000000000000000000000
0000111111111111111100000000000000000000
0000000000000000000100000000000000000000
