0000010000000000000000000000000000000000
0000010000000000000000000000000000000000
0000010000000000000000000011111000000000
0000010000001111111000000010001000000000
0000010000001000001000000010001000000000
1111110000001000001000011110001110000000
0000010000001000001000010000000010000000
0000010000001000001001110000000010000000
0000010000001000001001000000000010000000
0000011111111000001111000000000010000000
0000000000000000000000000000000011111222
0000000000000000000000000000000000000222
0000000000000000000000000000000011111222
0000011111111000001111000000000010000000
0000010000001000001001000000000010000000
0000010000001000001001110000000010000000
0000010000001000001000010000000010000000
1111110000001000001000011110001110000000
0000010000001000001000000010001000000000
0000010000001111111000000010001000000000
0000010000000000000000000011111000000000
0000010000000000000000000000000000000000
0000010000000000000000000000000000000000
