0000000000000100000000000000000000000000
0000000000000100111111111111111111111000
0000000000111100100000000000000000001000
0000000000100000100000000000000000001000
0000000000100000100111111111111111001000
0000000000100000100100000000000001001000
0011111100111111100100000000000001001000
0010000100000000000111111111110001001000
0010000100000000000000000000010001111000
0010000100000000111100111100011100000000
1110000100000000100100100100000100000222
0000011100111111100100100100111111111222
0000010000100000000100100100100100000222
0001110000100000000100100100100100000000
0001000011100000000111100111100101111000
0001000010000000000000000000000101001000
0001000010111111100111111111111101001000
0001000010100000100100000000000001001000
0001000010100000100100000000000001001000
0001000010100000100111111111111111001000
0001111110111100100000000000000000001000
0000000000000100111111111111111111111000
0000000000000100000000000000000000000000
