1111111111111111111111111111111111111111
0000111111111111111111111111111111111111
1110111111111111111111111111111111111111
1110111111111111111111111111111111111111
1110111111111111111111111111111111111111
1110111111111111111111100000000111111111
1110111111111111111111101111110111111111
1110111111111111111111101111110111111111
1110111111111111111111101111110111111111
1110111111111111111111101111110111111111
1110000111111111111111101111110111111222
1110110111111111111111101111110111000222
1110110001111111111000001111110111011222
1110111101111111111011111111110111011111
1110111101111111111011111111110111011111
1110111101111111111011111111110111011111
1110111101111110000011111111110111011111
1110111101111110111111111111110000011111
1110111101111110111111111111111111111111
1110111101111110111111111111111111111111
1110111100000000111111111111111111111111
0000111111111111111111111111111111111111
1111111111111111111111111111111111111111
